pushpa: pushpa
labor: labor labors
work: worked works work working
small: small
sum: sum
dream: dreamed dreams dream
live: live lived lives living
life: life lives
king: king
but: but
always: always
let: lets let
step: step steps
brother: brothers brother
illegitimate: illegitimate
child: child children
father: father
he: his he
get: got gets get getting
chance: chance chances
dense: dense
forest: forests forest
red: red
sander: sanders
smuggle: smuggle smuggled
country: country countries
the: the
scanner: scanner
dsp: dsp
govindappa: govindappa
dare: dares daring
go: gone goes go going went
everyone: everyone
create: create creating created creates
hurdle: hurdles
manage: managed manages managing
save: saves save
smuggling: smuggling
consignment: consignment
worth: worth
crore: crores crore
eye: eyes eye
become: became becoming become becomes
known: known
reddy: reddy
konda: konda
jakka: jakka
jolly: jolly
know: know known knew knows knowing
often: often
trick: tricks
bluff: bluffing
team: team
close: closed close
side: side
change: changed changes change changing
lifestyle: lifestyle
decide: decides decided decide
marry: marries marrying married marry
srivellus: srivelli
disclose: disclose
mother: mother
relationship: relationship relationships
thus: thus
call: calls calling call called
marriage: marriage
stop: stop stops
reach: reaches reach reaching
height: height heights
find: found find finding finds
mangalam: mangalam
sinu: sinu
syndicate: syndicate
member: members member
give: gives giving given gave give
gang: gang gangs
much: much
lesser: lesser
share: shares share
deserve: deserve
ask: asking asks asked ask
hike: hike
profit: profit
take: take takes taking taken took
thing: thing things
sin: sin
hand: hands
involvement: involvement
lead: lead led leads leading
war: wars war
two: two
fearless: fearless
control: controlling control controlled controls
disagreement: disagreements
a: a an
passionate: passionate
love: loved love loves
story: story stories
involve: involving
couple: couples couple
highlight: highlights highlight
contrast: contrast
regular: regular
mature: matures mature maturing
yet: yet
egoistic: egoistic
husband: husband
unique: unique
happy: happy
lucky: lucky
enamored: enamored
overzealous: overzealous
boy: boy
chase: chasing
among: among
normal: normal
human: humans human
other: others
possess: possessing
various: various
supernatural: supernatural
power: power powers
they: their they
divide: divided
force: forced force forces
light: lights light
dark: dark
sign: sign signed signs
truce: truce
several: several
century: centuries century
ago: ago
end: ending end ends ended
devastating: devastating
battle: battling battle
ever: ever
since: since
govern: govern
day: day days
night: night nights
belong: belonging belongs belong
opponent: opponents
in: in
modern: modern
moscow: moscow
actually: actually
roam: roam
vampire: vampires
watch: watch watching
anton: anton
movie: movie movies
protagonist: protagonist
try: trying tried try tries
limit: limit
outrage: outrage
ortmann: ortmann
armin: armin
unseen: unseen
man: man men
regain: regains
consciousness: consciousness
no: no
one: one ones
seem: seem seems
able: able
see: seeing sees seen see
except: except
mysterious: mysterious
dress: dressed
black: black
eventually: eventually
learn: learn learning learns
discussion: discussions
french: french
aristocrat: aristocrat
coin: coins
european: european
this: this
turn: turn turned turns
event: events
unusual: unusual
knowledge: knowledge
present: presented present presenting
quickly: quickly
winter: winter
palace: palace
hermitage: hermitage
petersburg: petersburg
comprehensive: comprehensive
russian: russians russian
history: history
time: times time
as: as
travel: travels travel traveling traveled
grounds: grounds
interact: interact
people: people
era: eras era
either: either
happen: happening happened happen
view: viewing views
artifact: artifacts
house: housed house houses
museum: museum
ultimately: ultimately
desire: desired desire desires
journey: journey
move: moves moving move
forward: forward
without: without
companion: companion
sobibor: sobibor
base: based
sobibór: sobibór
extermination: extermination
camp: camp
uprising: uprising
wwii: wwii
soviet: soviet
officer: officers officer
alexander: alexander
pechersky: pechersky
when: when
pow: pow
impossible: impossible
organize: organize
revolt: revolt
mass: mass
escape: escaped escapes escape
prisoner: prisoner prisoners
many: many
escapee: escapees
later: later
catch: catches caught
die: die died dies
rest: rest
join: joins join
partisan: partisans
script: script
book: book
ilya: ilya
vasiliev: vasiliev
breakthrough: breakthrough
immortality: immortality
berlin: berlin
summer: summer
city: cities city
chaos: chaos
law: law laws
criminal: criminals criminal
survivor: survivors survivor
american: american
cop: cop cops
max: max
mclaughlin: mclaughlin
taylor: taylor
kitsch: kitsch
waco: waco
friday: friday
arrive: arrive arrives
help: helped helping help helps
police: police
al: al
capone: capone
dr: dr
werner: werner
gladow: gladow
also: also
private: private
mission: mission
track: tracks track
miss: misses missing
kill: killing kills kill killed
former: former
nazis: nazis
hiding: hiding
director: director
pavel: pavel
ruminov: ruminov
film: filmed film films
actress: actress
nataliia: nataliia
anisimova: anisimova
break: breaks break broken
want: wants wanting wanted want
apartment: apartment
natalia: natalia
agree: agree
affair: affairs affair
although: although
say: said says
new: new
girlfriend: girlfriend girlfriends
masha: masha
she: her she
claim: claim claims claiming
year: years year
reconstruct: reconstruct
make: makes make making made
style: style
wave: wave
process: process
gerald: gerald
alter: alter
ego: ego egos
dissatisfy: dissatisfied
wake: waking wake
inside: inside
laboratory: laboratory
airship: airship
recall: recalls
bully: bullied bullies
childhood: childhood
scientist: scientist scientists
estelle: estelle
greet: greets
tell: telling tell told tells
name: named name
henry: henry
wife: wife
revive: revived revives
accident: accident
leave: left leave leaving leaves
amnesiac: amnesiac
mute: mute
after: after
replace: replaces replace
missing: missing
arm: arm arms
leg: leg
cybernetic: cybernetic
prosthesis: prostheses
mercenary: mercenaries mercenary
psychokinetic: psychokinetic
akan: akan
raid: raid
ship: ship
research: research
corporate: corporate
property: property properties
attempt: attempt attempting attempts
murder: murdering murders murdered murder
flee: flee fleeing flees
pod: pod
landing: landing
abduct: abduct abducted
group: group
agent: agents agent
paris: paris
france: france
need: need
figure: figure figures
carry: carry carried carrying
agency: agencies agency
leader: leader
passing: passing
drama: drama
play: played plays play
like: like
soap: soap
opera: opera
realistic: realistic
problem: problem problems
concern: concerns concern concerning
gymnastics: gymnastics
induce: induce
viewer: viewer viewers
believe: believes believe believed
plot: plot plots
still: still
roof: roof
boris: boris
zhenya: zhenya
terrible: terrible
final: final
stage: stages stage
bitter: bitter
divorce: divorce
under: under
circumstance: circumstances
already: already
partner: partner partners
insult: insults
pour: pour
rain: rain
toxic: toxic
familial: familial
zone: zone
pivot: pivoting
around: around
irresolvable: irresolvable
urgent: urgent
matter: matters matter
alyosha: alyosha
custody: custody
son: sons son
unheard: unheard
unloved: unloved
unwanted: unwanted
introverted: introverted
unhappy: unhappy
feel: feels feel
intolerable: intolerable
burden: burden
however: however
parent: parents
hear: hearing heard hear
every: every
single: single
word: word
result: result resulting results
finally: finally
realize: realize realizing realizes
nearly: nearly
late: late
simple: simple
case: case
runaway: runaway
teenager: teenagers teenager
rigana: riganas
secret: secret
magic: magic
send: sends sent
best: best
hansel: hansel
gretel: gretel
fight: fighting fought fight fights
witch: witch
gingerbread: gingerbread
early: early
cartographer: cartographer
jonathan: jonathan
green: green
undertake: undertaken undertakes
scientific: scientific
voyage: voyage
europe: europe
east: east
have: having
pass: passes passed pass
transylvania: transylvania
cross: cross crosses crossed
carpathian: carpathian
mountain: mountains mountain
village: village
lose: lost lose
impassible: impassible
wood: woods
nothing: nothing
heavy: heavy
fog: fog
could: could
bring: bringing brings brought bring
cursed: cursed
place: place
resemble: resembles resemble
traveler: traveler
saw: saw
villager: villagers
dig: dug digs
deep: deep
moat: moat
fend: fend
world: worlds world
naive: naive
belief: beliefs belief
evil: evil
fail: failed failing
understand: understand
nest: nest
soul: souls soul
wait: waiting
opportunity: opportunity
gush: gush
upon: upon
compelling: compelling
family: family families
friend: friend friends
foe: foes foe
indian: indian
drug: drugged drugs drug
industry: industry industries
while: while
bigger: bigger
slice: slice
pie: pie
ensue: ensues
difficult: difficult
can: can
aarya: aarya
rise: rise rises rose
occasion: occasion
rajakannu: rajakannu
sengenus: sengeni
lower: lower
cast: cast
field: fields field
protect: protect protecting
rat: rats
thou: thou
poverty: poverty
plan: plans plan planned
second: second
soon: soon
sengeni: sengeni
good: good
news: news
rajkannu: rajkannu
upper: upper
caste: caste
snake: snake
sneak: sneaked
next: next
theft: theft
jewelry: jewelry
report: reported
suspicious: suspicious
raising: raising
towards: towards
arrest: arrest arrested arrests
town: town towns
follow: follow follows following followed
detain: detain
pregnant: pregnant
senganus: sengani
detail: details
trace: trace traces traced
torture: torture
jail: jail
confess: confess
crime: crime
commit: commit
elope: eloped
prison: prisons prison
teach: taught teach teaches
tribal: tribal
come: come came comes coming
across: across
lawyer: lawyer
chandru: chandru
senegeni: senegeni
file: files
habeas: habeas
corpus: corpus
court: court
set: sets set
pulsate: pulsating
backdrop: backdrop
rustic: rustic
north: north
india: india
hostel: hostel
volatile: volatile
spirited: spirited
young: young
hunt: hunted hunting
ruthless: ruthless
ivan: ivan
naydenov: naydenov
transfer: transferred
fantasy: fantasy
belogorye: belogorye
inhabit: inhabited
character: character characters
fairy: fairy
tale: tales tale
hero: hero heroes
center: centered center centers
put: put putting puts
unfold: unfold unfolding unfolds
six: six
strange: strange
teenage: teenage
never: never
vanya: vanya
andrey: andrey
long: long
remember: remember
lived: lived
pilot: pilot
ordinary: ordinary
monday: monday
dad: dad
appear: appears
island: island
middle: middle
lake: lake
chernobyl: chernobyl
abyss: abyss
first: first
major: major
feature: features feature
aftermath: aftermath
explosion: explosion
nuclear: nuclear
station: station stations
hundred: hundreds hundred
sacrifice: sacrifice sacrificed
clean: clean
site: site
catastrophe: catastrophe
successfully: successfully
prevent: prevent
even: even
disaster: disaster
large: large
part: part parts
continent: continent
uninhabitable: uninhabitable
exclusion: exclusion
unlikely: unlikely
alexey: alexey
fireman: firemen fireman
accompany: accompanied
valery: valery
engineer: engineer engineering
bori: boris
military: military
diver: diver
perilous: perilous
drain: drain
water: water
reservoir: reservoir
burn: burns burning
reactor: reactor
proper: proper
planning: planning
flood: flooded
corridor: corridors
traverse: traverse
hotter: hotter
hour: hours hour
molten: molten
core: core
seep: seeps
closer: closer
prepared: prepared
order: orders order
greater: greater
three: three
descend: descends descend
depths: depths
building: buildings building
villefranche: villefranche
phone: phone phones
reception: reception
edge: edge
number: number numbered
inhabitant: inhabitants
dwindle: dwindling
sharp: sharp
inspector: inspector
laurène: laurène
victim: victim
keep: keeps kept keeping keep
discover: discovering discover discovers discovered
fresh: fresh
corpse: corpses
fred: fred
madison: madison
saxophonist: saxophonist
accuse: accused accuses
renee: renee
on: on
death: death
row: row
inexplicably: inexplicably
morph: morphs
pete: pete
dayton: dayton
completely: completely
different: different
release: released
path: path paths
begin: begins begin begun began beginning
surreal: surreal
suspenseful: suspenseful
web: web
intrigue: intrigue intrigues
orchestrate: orchestrates orchestrated
shady: shady
gangster: gangster
boss: boss
dick: dick
laurent: laurent
jdean: jdean
english: english
traveller: traveller
jason: jason
flemyng: flemyng
receive: receiving receive receives
peter: peter
great: great
map: map mapped
far: far
once: once
full: full
incredible: incredible
adventure: adventures
china: china
unexpectedly: unexpectedly
face: facing face faces
lot: lot
breathtaking: breathtaking
discovery: discovery discoveries
encounter: encounter encounters
bizarre: bizarre
creature: creatures
meet: met meets meet
chinese: chinese
princess: princesses princess
confront: confronting confront
deadly: deadly
martial: martial
art: art arts
master: masters master
dragon: dragons dragon
what: what
dangerous: dangerous
meeting: meeting
viy: viy
would: would
stronger: stronger
staunch: staunch
skepticism: skepticism
old: old
seize: seize seized
eastern: eastern
land: land lands
nato: nato
bomb: bombs
belgrad: belgrad
march: march
serb: serbs serb
army: army
pull: pulls
kosovo: kosovo
june: june
serbian: serbian
minority: minority
unprotected: unprotected
plunder: plundering
rape: raped raping rape
bandit: bandits
target: target targeting
airport: airport
hold: hold held holds
peacekeeper: peacekeepers
filtenborg: filtenborg
kievan: kievan
rus: rus
svyatoslav: svyatoslav
i: i
ruler: ruler
vike: viking
prince: prince
vladimir: vladimir
novgorod: novgorod
danila: danila
kozlovskiy: kozlovskiy
exile: exile
freeze: frozen freezing
sea: sea
treacherous: treacherous
yaropolk: yaropolk
aleksandr: aleksandr
ustyugov: ustyugov
oleg: oleg
kirill: kirill
pletnyov: pletnyov
conquer: conquered conquer
territory: territory
warrior: warrior
sveneld: sveneld
maksim: maksim
sukhanov: sukhanov
convince: convinces convince convinced
assemble: assembles assemble
varangian: varangian
armada: armada
hope: hoped hoping hopes hope
reconquer: reconquer
mighty: mighty
byzantine: byzantine
upright: upright
retire: retired
havildar: havildar
clash: clash
cricket: cricket
select: selected select
third: third
cup: cup
england: england
none: none
expectation: expectations
official: officials official
appointment: appointment
captain: captain
kapil: kapil
dev: dev
sunil: sunil
start: start starts started
bang: bang
win: winning win
match: match matches
giant: giant giants
west: west
indy: indies
zimbabwe: zimbabwe
loose: looses loosing loose
australia: australia
situation: situation
stay: stay
big: big
half: half
back: back
pavilion: pavilion
over: overs
score: score
run: run runs
show: showed show showing shows
alive: alive
tournament: tournament
spirit: spirit
lord: lords lord
champion: champions
consider: consider considered considers
worthy: worthy
due: due
confidence: confidence
series: series
depict: depicts
sexual: sexual
attraction: attraction
whole: whole
webcam: webcam
outsider: outsiders outsider
afraid: afraid
feeling: feeling feelings
addict: addict addicted
porn: porn
suffer: suffered suffering suffers
social: social
phobia: phobia
prone: prone
spending: spending
home: homes home
anxious: anxious
fully: fully
aware: aware
body: bodies body
experience: experiences experience experienced
orgasm: orgasm
newly: newly
discharge: discharged
older: older
killer: killer
situate: situated
someone: someone
there: there
include: includes including include
girl: girl girls
fan: fans fan
rock: rock
band: band
nautilus: nautilus
pompillius: pompillius
easier: easier
living: living
wrong: wrong
way: way ways
volovik: volovik
dimaa: dimaa
robot: robots
raise: raised raise
personal: personal
driver: drivers driver
security: security
guard: guards
lover: lovers
for: for
bot: bots
soulless: soulless
machine: machines
perform: performing perform
routine: routine
capable: capable
emotion: emotions
rebel: rebels
liquidator: liquidators
reject: reject rejects rejected
ready: ready
shed: shed
blood: blood
barney: barney
stallone: stallone
christmas: christmas
statham: statham
conrad: conrad
stonebank: stonebanks
gibson: gibson
expendable: expendables
subsequently: subsequently
trader: trader
thought: thought
elude: eluded
recruit: recruiting recruits recruited
individual: individual individuals
younger: younger
faster: faster
latest: latest
classic: classic
versus: versus
expertise: expertise
anne: anne
woman: women woman
abort: abort
finish: finish
study: study studies studying
constraint: constraints
society: society
censure: censures
and: and
sex: sex
general: general
cruel: cruel
itinerary: itinerary
little: little
exam: exams
corner: corner
baby: baby
bump: bump
grow: grew grows grown growing
fast: fast
greatest: greatest
trial: trials trial
mankind: mankind
depend: depend
action: actions action
swear: sworn swearing
enemy: enemies enemy
collapse: collapse
be: is being
captivity: captivity
lieutenant: lieutenant
ivushkin: ivushkin
crew: crew
challenge: challenges challenge
german: german
tank: tank
ace: aces
jager: jager
sake: sake
till: till
media: media
entertainment: entertainment
unfulfilled: unfulfilled
sergeant: sergeant
anti: anti
aircraft: aircraft
outpost: outpost
soldier: soldier soldiers
command: command
special: special
spottet: spottet
five: five
nazi: nazi nazis
goal: goal goals
during: during
memory: memory memories
recap: recaps
earlier: earlier
abolition: abolition
penalty: penalty
overflow: overflowing
globe: globe
authority: authority authorities
solution: solution
colonize: colonize
deposit: deposited
pile: pile
key: key keys
unlock: unlocking unlock
chain: chains chain
retreat: retreat
safe: safe
distance: distance
all: all
hell: hell
scene: scene scenes
carnage: carnage
chechen: chechens
uncontrolled: uncontrolled
act: act acts
murderous: murderous
violence: violence
kardaris: kardaris
race: race
rescue: rescue rescued
boyfriend: boyfriend
sticky: sticky
looop: looop
lapeta: lapeta
promise: promises promising
adventurous: adventurous
ride: ride
trigger: trigger triggers triggering
fortunate: fortunate
unfortunate: unfortunate
rinku: rinku
goon: goons
uncle: uncles
junction: junction
vishu: vishu
madhusudhan: madhusudhan
throw: throw throwing
bottle: bottles
bough: bough
grandmother: grandmother
married: married
mandakini: mandakini
kidnap: kidnapped kidnaps kidnap
forcefully: forcefully
delhi: delhi
valid: valid
sajjad: sajjad
wont: wont
south: south
madurai: madurai
video: video
return: returns returned return
develop: develops developed
eager: eager
whose: whose
exist: exist
reality: reality
imaginary: imaginary
farhan: farhan
qureshi: qureshi
raju: raju
rastogi: rastogi
fellow: fellow
collegian: collegian
rancho: rancho
fake: fake faking
stroke: stroke
aboard: aboard
air: air
plane: plane
excuse: excusing
trouser: trouser
less: less
respectively: respectively
enroute: enroute
another: another
student: student students
chatur: chatur
ramalingam: ramalingam
successful: successful
businessman: businessmen businessman
remind: reminds
bet: bet
trio: trio
recollect: recollecting
hilarious: hilarious
antic: antics
dean: dean
imperial: imperial
college: college
engineering: engineering
viru: viru
sahastrabudhe: sahastrabudhe
locate: locate located
last: last
address: address
gunwantus: gunwanti
empress: empress
ekaterina: ekaterina
ii: ii
catherine: catherine
bear: born
russia: russia
bride: bride
iii: iii
choose: chosen chooses
aunt: aunt
elisabeth: elisabeth
transform: transforms transformed transform
empire: empire
anarchist: anarchist
nickname: nicknamed
karamora: karamora
monarchical: monarchical
dynasty: dynasties dynasty
highest: highest
rank: ranks
nobility: nobility
elite: elites elite
discreetly: discreetly
use: using uses use
rule: rule ruled rules
period: period periods
declare: declared declares
harm: harm
cause: causes causing caused
tokyo: tokyo
nasty: nasty
underside: underside
primarily: primarily
oscar: oscar
user: user
sister: sisters sister
linda: linda
stripper: stripper
flashback: flashbacks
trauma: trauma
upend: upends upended
sibling: siblings
hallucination: hallucinations
shoot: shoot shot
float: float
look: looking looks look
sorrow: sorrow
room: rooms room
hotel: hotel
molecular: molecular
level: level
spectrum: spectrum
color: colors
beautiful: beautiful
colorless: colorless
ugly: ugly
afterlife: afterlife
void: void
jhailey: jhailey
december: december
vyazma: vyazma
cauldron: cauldron
comrade: comrades
encirclement: encirclement
suddenly: suddenly
unequal: unequal
unit: unit
wehrmacht: wehrmacht
brave: brave
ghost: ghost
myth: myth
lone: lone
pick: picking pick picks
vanish: vanishes vanish vanishing
almost: almost
magically: magically
dead: dead
northwestern: northwestern
front: front
column: column
advance: advance
nikolai: nikolai
komlev: komlev
shot: shot
remote: remote
clearing: clearing
friendly: friendly
ahead: ahead
relentless: relentless
severe: severe
physical: physical
mental: mental
endurance: endurance
hunger: hunger
extreme: extreme extremes
cold: cold
evading: evading
pack: packs packed
wolf: wolves wolf
detachment: detachments
wound: wounded
safety: safety
biographical: biographical
inventor: inventor
designer: designer
mikhail: mikhail
timofeevich: timofeevich
kalashnikov: kalashnikov
today: today
person: person
thorny: thorny
guy: guy
legendary: legendary
weapon: weapon weapons
age: age aging
symbol: symbol
think: thought think
gille: gilles
belgian: belgian
ss: ss
alongside: alongside
jew: jews
concentration: concentration
germany: germany
narrowly: narrowly
avoid: avoids avoid
execution: execution
jewish: jewish
persian: persian
lie: lies lie
temporarily: temporarily
assign: assigned
seemingly: seemingly
untenable: untenable
koch: koch
charge: charge charged
kitchen: kitchen
open: open opening opens
restaurant: restaurant
persia: persia
iran: iran
invent: invent
language: language languages
incite: incite
jealousy: jealousy
suspicion: suspicion
acutely: acutely
false: false
expose: expose exposed
swindle: swindle
fronde: fronde
defy: defy
disobey: disobey
monarchy: monarchy
loui: louis
xiv: xiv
château: château
de: de
near: near
hunting: hunting
lodge: lodge
hamlet: hamlet
versaille: versailles
mean: meaning means
submission: submission
renovate: renovates
expand: expands
usual: usual
surroundings: surroundings
compel: compelled
surround: surrounding surround
embroil: embroiled
increasingly: increasingly
leningrad: leningrad
devastate: devastated
demolish: demolishing
citizen: citizens
tatters: tatters
physically: physically
mentally: mentally
siege: siege
worst: worst
continue: continue continues
wreckage: wreckage
remain: remains
iya: iya
search: searches search
struggle: struggling struggle
rebuild: rebuild
amongst: amongst
ruin: ruin ruins ruined
kantemir: kantemir
balagov: balagov
tesnota: tesnota
winner: winner
fipresci: fipresci
prize: prize
canne: cannes
festival: festival
powerful: powerful
emotional: emotional
arun: arun
carefree: carefree
bachelor: bachelor
phase: phases
date: dating dated dates
here: here
incident: incident incidents
birth: births birth
kolar: kolar
gold: gold
mumbai: mumbai
mafia: mafia
wish: wish wishes
rich: rich
will: wo will
don: don
free: free
slavery: slavery
form: forms form
nc: nc
encanto: encanto
extraordinary: extraordinary
madrigal: madrigals madrigal
hide: hidden hides hiding hide
colombia: colombia
magical: magical
vibrant: vibrant
wondrous: wondrous
charmed: charmed
bless: blessed
gift: gift
super: super
strength: strength
mirabel: mirabel
danger: danger
might: might
exceptional: exceptional
disney: disney
animation: animation
studio: studios
televangelist: televangelist
tradition: tradition traditions
deviance: deviance
greed: greed
charitable: charitable
rowdy: rowdy
ragtag: ragtag
misfit: misfits misfit
hire: hire
vox: vox
machina: machina
interested: interested
easy: easy
money: money
cheap: cheap
ale: ale
realm: realm
kingdom: kingdoms kingdom
threaten: threatens threaten threatened
boisterous: boisterous
restore: restoring
justice: justice
payday: payday
origin: origin
behind: behind
exandria: exandria
newest: newest
seventeen: seventeen
kim: kim
pride: pride
joy: joy
bryan: bryan
mill: mills
retired: retired
central: central
intelligence: intelligence
california: california
lenore: lenore
wealthy: wealthy
stepfather: stepfather
stuart: stuart
reluctant: reluctant
allow: allow allowed
amanda: amanda
cab: cab
stranger: strangers stranger
slip: slip
alone: alone
information: information
albanian: albanian
trafficker: traffickers
barely: barely
speak: speak
briefly: briefly
kidnapper: kidnappers kidnapper
daughter: daughter daughters
luck: luck
carvalho: carvalho
rio: rio
janeiro: janeiro
brazil: brazil
nelly: nelly
explore: explore explores exploring
treehouse: treehouse
it: it
narrative: narrative
well: well wells
mahaan: mahaan
duo: duo
vikram: vikram
dhruv: dhruv
together: together
along: along
bobby: bobby
simha: simha
simran: simran
pivotal: pivotal
role: role roles
stray: strays
ideological: ideological
freedom: freedom
ambition: ambitions ambition
presence: presence
fulfil: fulfilled
billionaire: billionaire
unexpected: unexpected
thrilling: thrilling
shardul: shardul
thakur: thakur
post: posted
dehradhun: dehradhun
designate: designated
pressurize: pressurized
suman: suman
pt: pt
teacher: teacher
school: school
pressure: pressure
sumi: sumi
keen: keen
register: registers
app: app
female: female
actual: actual
male: male
blackmail: blackmail
truth: truths truth
spend: spend spends
frequently: frequently
revel: revels
sumus: sumi
kabir: kabir
fall: fall fell falls fallen
arise: arises
kid: kid kids
suppose: supposed
job: job jobs
lucy: lucy
deliver: deliver
briefcase: briefcase
jang: jang
immediately: immediately
nightmarish: nightmarish
deal: deal
capture: captures capture captured
mule: mule
synthetic: synthetic
bag: bag
stomach: stomach
leak: leaks
undergo: undergoes
unimaginable: unimaginable
mind: mind
potential: potential
with: with
merciless: merciless
intent: intent intents
captor: captors
invaluable: invaluable
professor: professor
norman: norman
pierre: pierre
del: del
fifteen: fifteen
horrifying: horrifying
abduction: abduction
prolong: prolonged
lucie: lucie
embark: embark embarks
bloody: bloody
quest: quest
revenge: revenge
oppressor: oppressors
anna: anna
abuse: abuse abused
madness: madness
delusion: delusions
twelve: twelve
murphy: murphy
cinema: cinema
electra: electra
threesome: threesome
blonde: blonde
danish: danish
omi: omi
add: add added
excitement: excitement
unplanned: unplanned
pregnancy: pregnancy
horrible: horrible
note: note
morning: morning
nora: nora
month: months month
suicidal: suicidal
tendency: tendencies
past: past pasts
fragment: fragmented
nonlinear: nonlinear
quick: quick
hookup: hookup
fill: filled
rough: rough
tender: tender
moment: moment moments
scion: scion
conservative: conservative
infiltrate: infiltrate
neighboring: neighboring
clan: clan
dominate: dominating dominated
railroad: railroad
tycoon: tycoon
george: george
russell: russell
rakish: rakish
larry: larry
ambitious: ambitious
bertha: bertha
parker: parker
identity: identity identities
reveal: reveal revealing revealed reveals
entire: entire
desperate: desperate
doctor: doctor
forget: forgotten forget
spell: spell
horribly: horribly
shatter: shatters
multiverse: multiverse
monstrous: monstrous
villain: villain villains
destroy: destroying destroyed destroy
stan: stan
carny: carny
carnival: carnival
disturb: disturbed
sink: sink
geek: geek
clem: clem
explain: explains
seek: seeking seeks
alcoholic: alcoholic
trouble: troubled troubles trouble
lure: lures
temporary: temporary
alcohol: alcohol
dependence: dependence
depravity: depravity
clairvoyant: clairvoyant
madame: madame
zeena: zeena
warn: warn warning
skill: skills
otherwise: otherwise
hurt: hurt
meanwhile: meanwhile
attracted: attracted
performer: performer
molly: molly
approach: approaches
idea: idea
away: away
manhattan: manhattan
marvelous: marvelous
maisel: maisel
dramedy: dramedy
miriam: miriam
midge: midge
sunny: sunny
energetic: energetic
yom: yom
kippur: kippur
breakfast: breakfasts
enough: enough
exactly: exactly
happily: happily
cheerleader: cheerleader
comedy: comedy
career: career
perfect: perfect
utterly: utterly
unprepared: unprepared
choice: choice
reevaluate: reevaluate
accidentally: accidentally
stumble: stumbles
onto: onto
nightclub: nightclub
comedic: comedic
newfound: newfound
talent: talent
reinvent: reinvent
trajectory: trajectory
pursue: pursue pursues
profession: profession
uptown: uptown
matron: matron
club: club
sheriff: sheriff
deputy: deputy
rick: rick
grimes: grimes
coma: coma
awake: awoken
zombie: zombie
apocalypse: apocalypse
not: not
do: done
connected: connected
survive: surviving survive survived
food: food
survival: survival
risk: risks
amélie: amélie
suppress: suppressed
mistaken: mistaken
heart: heart
defect: defect
hardly: hardly
contact: contact contacts
resort: resort
fantastical: fantastical
beauty: beauty
waitress: waitress
treasure: treasure
occupant: occupant
reaction: reaction
perspective: perspective
devote: devote
such: such
obsess: obsessed
writer: writer
hypochondriac: hypochondriac
stalk: stalks
ex: ex
bone: bones
brittle: brittle
glass: glass
consume: consuming
escapade: escapades
disregard: disregarding
damage: damaged damaging
must: must
aggressive: aggressive
pup: pup
lion: lion
cub: cub
canadian: canadian
wilderness: wilderness
friendship: friendship
forever: forever
cheg: cheg
context: context
deteriorate: deteriorated
countrywide: countrywide
economic: economic
crisis: crisis
upside: upside
cecile: cecile
symbolize: symbolizes
recently: recently
bury: bury
grief: grief
relation: relations
petty: petty
satisfy: satisfy
constant: constant
carnal: carnal
alice: alice
refuse: refuses
auto: auto
mechanic: mechanic
advice: advice
pleasure: pleasure
unable: unable
inner: inner
peace: peace
matt: matt
healing: healing
arjun: arjun
ip: ips
illegal: illegal
biker: bikers
homi: homi
jehangir: jehangir
bhabha: bhabha
ambalal: ambalal
sarabhai: sarabhai
future: future
robin: robin
locksley: locksley
skilled: skilled
archer: archer
holy: holy
crusade: crusades
richard: richard
lionheart: lionheart
longtime: longtime
john: john
assume: assumed
throne: throne
absence: absence
neurotic: neurotic
basically: basically
equally: equally
rottingham: rottingham
everything: everything
fatten: fatten
coffer: coffers
expense: expense
commoner: commoners
peasant: peasants
merry: merry
blinkin: blinkin
blind: blind
servant: servant
ahchoo: ahchoo
misguided: misguided
asneeze: asneeze
fighting: fighting
coincidental: coincidental
fact: fact
hulking: hulking
scarlet: scarlet
dagger: daggers
sight: sight
marian: marian
bagelle: bagelle
maid: maid
figurative: figurative
literal: literal
object: object
latrine: latrine
hag: hag
sorceress: sorceress
particular: particular
mentality: mentality
achieve: achieve
protection: protection
trust: trusted
royal: royal
cherry: cherry
painter: painter
marianne: marianne
commission: commissioned
wedding: wedding
portrait: portrait
héloïse: héloïse
therefore: therefore
observe: observe
model: models model
paint: paint
impend: impending
aristocratic: aristocratic
intellectual: intellectual
philippe: philippe
quadriplegic: quadriplegic
millionaire: millionaire
interview: interviewing
candidate: candidates
position: position
carer: carer
secretary: secretary
magalie: magalie
out: out
blue: blue
driss: driss
cut: cut cuts
line: line
document: document
phillipe: phillipe
prove: prove proves
unemployment: unemployment
benefit: benefit
offer: offering offers offered
gain: gaining gain gained
then: then
whether: whether
accept: accepts accepted
mansion: mansion mansions
boring: boring
employee: employees
pamela: pamela
anderson: anderson
tommy: tommy
lee: lee
whirlwind: whirlwind
romance: romance
task: tasked task
sixth: sixth
branch: branch
armed: armed
service: services
space: space
original: original
woodsboro: woodsboro
ghostface: ghostface
emerge: emerges emerge
sidney: sidney
prescott: prescott
uncover: uncover
public: public
conference: conference
state: states state
chief: chief
minister: minister
bodyguard: bodyguard
stick: stuck
loop: loop
mythical: mythical
westero: westeros
seven: seven
conflict: conflict conflicts
erupt: erupts
ancient: ancient
heir: heirs heir
usurp: usurped
homeland: homeland
narrow: narrow
gray: gray
roll: roll
star: star
elvis: elvis
presley: presley
battalion: battalion
cavalry: cavalry
regiment: regiment
calvary: calvary
division: division
overwhelming: overwhelming
odds: odds
ia: ia
drang: drang
valley: valley
vietnam: vietnam
commander: commander
colonel: colonel
hal: hal
moore: moore
mel: mel
preparation: preparations
we: us we
defeat: defeated
area: area
engagement: engagement
helicopter: helicopters
mobility: mobility
provider: providers
assault: assault
support: support
sasha: sasha
luss: luss
fashion: fashion
more: more
short: short
enter: enters entered enter
influential: influential
interrogate: interrogated
absolutely: absolutely
scared: scared
suspect: suspects suspect
prepare: preparing
business: business
guise: guise
fragile: fragile
assassin: assassin
misfire: misfired
government: government
eiffel: eiffel
design: design
something: something
spectacular: spectacular
fair: fair
simply: simply
subway: subway
sell: sold selling sells
brothel: brothel
rashmibai: rashmibai
flesh: flesh
gangubai: gangubai
kathiawadi: kathiawadi
aka: aka
ganga: ganga
bombay: bombay
ramnik: ramnik
shelia: shelia
option: option
hence: hence
prostitute: prostitute
respect: respect respected
main: main
sheila: sheila
bond: bonds
rahim: rahim
lala: lala
brotherly: brotherly
queen: queen
better: better
politics: politics
contender: contender
raziabai: raziabai
opposite: opposite
universe: universe
fifth: fifth
element: element elements
earth: earth
thousand: thousand thousands
four: four
stone: stone stones
fire: fired fire
mondoshawan: mondoshawan
spacecraft: spacecraft
mangalore: mangalores
dna: dna
leeloo: leeloo
taxi: taxi
commando: commando
korben: korben
dallas: dallas
vito: vito
cornelius: cornelius
accomplish: accomplish
greedy: greedy
emanuel: emanuel
zorg: zorg
retrieve: retrieve
dalla: dallas
turbulent: turbulent
professional: professional
cruelly: cruelly
abandon: abandon abandoned
sam: sam
despite: despite
estrangement: estrangement
blooded: blooded
hitwoman: hitwoman
spin: spins
innocent: innocent
unleash: unleashed unleash
rogue: rogue
hitwomen: hitwomen
sidekick: sidekicks
avenge: avenge avenging avenges
rigorous: rigorous
vegetarian: vegetarian
freshman: freshman
justine: justine
reputable: reputable
veterinary: veterinary
leaf: leaves
abruptly: abruptly
mad: mad
vicious: vicious
initiation: initiation
test: tested tests test
chew: chew
unshakable: unshakable
herbivorous: herbivorous
deeper: deeper
hidden: hidden
uncharted: uncharted
animalistic: animalistic
unprecedented: unprecedented
morbid: morbid
craving: craving
meat: meat
expect: expected expecting
corporeal: corporeal
awakening: awakening
complete: complete
point: points point
deny: denying
raw: raw
yellowstone: yellowstone
dutton: dutton
largest: largest
contiguous: contiguous
ranch: ranch
united: united
attack: attack
border: borders
developer: developers
reservation: reservation
america: america
national: national
park: park
intense: intense
violent: violent
scrutiny: scrutiny
grab: grabs
billion: billions billion
politician: politicians politician
buy: buys buying bought
oil: oil
lumber: lumber
corporation: corporations
where: where
drink: drinking
poison: poisoned
frack: fracking
unsolved: unsolved
consequence: consequence consequences
frontier: frontier
represent: represents
from: from
unravel: unravels unravel
mystery: mysteries mystery
trap: traps trap
unwilling: unwilling
resident: residents
sense: sense
normalcy: normalcy
threat: threats threat
terrifying: terrifying
sun: sun
revolutionary: revolutionary
udham: udham
singh: singh
assassination: assassination
michael: michael
o: o
dwyer: dwyer
london: london
jallianwala: jallianwala
bagh: bagh
massacre: massacre
april: april
baisakhi: baisakhi
injure: injured
viking: vikings
valhalla: valhalla
chronicle: chronicles
famous: famous
leif: leif
eriksson: eriksson
freydi: freydis
eriksdotter: eriksdotter
harald: harald
hardrada: hardrada
william: william
conqueror: conqueror conquerors
these: these
blaze: blaze
evolve: evolves evolving
avenger: avengers
endgame: endgame
stephen: stephen
sorcerer: sorcerer
mess: messing
unspeakable: unspeakable
kat: kat
valdez: valdez
sexiest: sexiest
celebrity: celebrity
hot: hot
music: music
supernova: supernova
bastian: bastian
inescapable: inescapable
hit: hit
I: me
climb: climbs
chart: charts
wed: wed
audience: audience
ceremony: ceremony
stream: stream
multiple: multiple
platform: platforms
divorced: divorced
math: math
charlie: charlie
gilbert: gilbert
drag: dragged
concert: concert
lou: lou
debb: debbs
seconds: seconds
cheat: cheating cheats cheated
assistant: assistant
left: left
meltdown: meltdown
question: questioning question
loyalty: loyalty
gossamer: gossamer
lock: locks locked
crowd: crowd
if: if
perhaps: perhaps
answer: answers answer
inspire: inspired
insanity: insanity
impulsive: impulsive
conspire: conspire
separate: separate separated
universal: universal
bridge: bridge
gulf: gulf
build: build
arsène: arsène
lupin: lupin
gentleman: gentleman
thief: thief
assane: assane
diop: diop
injustice: injustice
inflict: inflicted
alpha: alpha
being: beings
planet: planet planets
exchange: exchanging
culture: culture
grant: granted grant
valerian: valerian
dane: dane
dehaan: dehaan
laureline: laureline
cara: cara
delevingne: delevingne
defense: defense
herbie: herbie
hancock: hancock
species: species
converter: converter
succeed: succeed
unknown: unknown
humanoid: humanoids
filitt: filitt
clive: clive
owen: owen
steal: steal
head: head
forbidden: forbidden
infect: infected infects
root: rooted roots
intricacy: intricacies
global: global
superstar: superstar
mom: mom
disappearance: disappearances disappearance
perfectly: perfectly
craft: crafted
facade: facade
strip: strip stripped
painful: painful
iconic: iconic
mid: mid
urban: urban
dancer: dancers dancer
rehearsal: rehearsal
boarding: boarding
dance: dance
party: party
sangria: sangria
bowl: bowl
atmosphere: atmosphere
charged: charged
obvious: obvious
neither: neither
resist: resist
neurosis: neuroses
psychosis: psychoses
numb: numbed
hypnotic: hypnotic
increase: increasing
electric: electric
rhythm: rhythm
paradise: paradise
plunge: plunged plunge
debt: debt
repay: repay
creditor: creditor
withdraw: withdraw
complaint: complaint
payment: payment
mythic: mythic
emotionally: emotionally
dune: dune
paul: paul
atreide: atreides
brilliant: brilliant
gifted: gifted
destiny: destiny
beyond: beyond
understanding: understanding
ensure: ensure
malevolent: malevolent
explode: explode
exclusive: exclusive
supply: supply
precious: precious
resource: resource
commodity: commodity
humanity: humanity
fear: fear
bro: bros
thriller: thriller
elena: elena
federova: federova
international: international
dealer: dealer
mastermind: mastermind
coordinate: coordinated
bank: bank
heist: heists heist
val: val
turner: turner
principled: principled
socially: socially
outcast: outcast
fbi: fbi
foil: foil
byrde: byrdes
charlotte: charlotte
jonah: jonah
purpose: purpose purposes
marty: marty
chicago: chicago
financial: financial
advisor: advisor
serve: serves serve
top: top
launderer: launderer
cartel: cartel
mexico: mexico
awry: awry
uproot: uproot
skyscraper: skyscrapers
relocate: relocate
lazy: lazy
region: region
missouri: missouri
ozark: ozarks
revolve: revolves
bantu: bantu
allu: allu
despise: despised
neglect: neglected
valmiki: valmiki
murali: murali
sharma: sharma
swap: swapped
latter: latter
comfortable: comfortable
draw: draws
learning: learning
vaikunthapuram: vaikunthapuram
real: real
nathan: nathan
drake: drake
tom: tom
holland: holland
seasoned: seasoned
hunter: hunter
victor: victor
sully: sully
sullivan: sullivan
mark: mark marks marked
wahlberg: wahlberg
recover: recovering recover
fortune: fortune
amass: amassed
ferdinand: ferdinand
magellan: magellan
moncada: moncada
santiago: santiago
antonio: antonio
bandera: banderas
rightful: rightful
nate: nate
decipher: decipher
clue: clues
solve: solve
oldest: oldest
stand: stand
tear: torn tear
apart: apart
religious: religious
difference: differences
teeter: teeters
extinction: extinction
atheistic: atheistic
android: android androids
architect: architect
creation: creations
peaceful: peaceful
godless: godless
colony: colony
executive: executive
producer: producer
ridley: ridley
scott: scott
virgin: virgin
jeopardized: jeopardized
arrival: arrival
mithraic: mithraic
deeply: deeply
devout: devout
zealous: zealous
fiercely: fiercely
peculiar: peculiar
fabric: fabric
community: community
converge: converge
local: local locals
j: j
cover: covering cover
corrupt: corrupt corrupted
spiral: spiral spirals
witness: witnesses witnessing witness
neil: neil
bennett: bennett
tim: tim
roth: roth
gainsbourg: gainsbourg
vacation: vacation
colin: colin
alexa: alexa
samuel: samuel
bottomley: bottomley
albertine: albertine
kott: kotting
mcmillan: mcmillan
distant: distant
emergency: emergency
trip: trip
relative: relative
disrupt: disrupt disrupts
simmer: simmering
tension: tensions
fore: fore
jolt: jolt
michel: michel
franco: franco
adèle: adèle
high: high
satisfaction: satisfaction
sexually: sexually
emma: emma
sexuality: sexuality
association: association
express: express
openly: openly
acceptance: acceptance
adolescence: adolescence
humbert: humbert
hopelessly: hopelessly
tragically: tragically
adulthood: adulthood
obsession: obsessions obsession
nymphet: nymphets
walk: walk
fine: fine
secure: secure securing
teaching: teaching
haze: haze
melanie: melanie
griffith: griffith
pretentious: pretentious
annoying: annoying
desperately: desperately
lonely: lonely
obviously: obviously
attract: attracted
pay: pays paying
lolita: lolita
dominique: dominique
swain: swain
image: image
boarder: boarder
rage: rage
fate: fate
traditional: traditional
boundary: boundaries
kate: kate
dibiasky: dibiasky
jennifer: jennifer
lawrence: lawrence
astronomy: astronomy
grad: grad
randall: randall
mindy: mindy
leonardo: leonardo
dicaprio: dicaprio
astounding: astounding
comet: comet
orbit: orbiting
within: within
solar: solar
system: system
direct: direct
collision: collision
course: course
really: really
care: care
size: size
mount: mount
everest: everest
inconvenient: inconvenient
navigate: navigate navigates navigating
oglethorpe: oglethorpe
rob: robbing rob
morgan: morgan
tour: tour
office: office
indifferent: indifferent
president: president
orlean: orlean
meryl: meryl
streep: streep
sycophantic: sycophantic
staff: staff
hill: hill
airwave: airwaves
daily: daily
rip: rip
upbeat: upbeat
host: hosted
brie: brie
cate: cate
blanchett: blanchett
jack: jack
tyler: tyler
perry: perry
impact: impacts impact
cycle: cycle
attention: attention
shockingly: shockingly
comical: comical
location: location locations
york: york
showcase: showcases
determine: determining determine determined
guilt: guilt
innocence: innocence
hang: hung hang
balance: balance
headline: headlines
legal: legal
ethical: ethical
dilemma: dilemmas
relate: relate
riddler: riddler
sadistic: sadistic
serial: serial
political: political
gotham: gotham
batman: batman
investigate: investigating investigate
corruption: corruption
ishaan: ishaan
awasthi: awasthi
wonder: wonders
else: else
appretiate: appretiate
important: important
adult: adults adult
homework: homework
neatness: neatness
anything: anything
right: right
class: class
handle: handle
discipline: disciplined
contend: contend
separation: separation
burst: bursts
ram: ram
shankar: shankar
nikumbh: nikumbh
optimism: optimism
imagine: imagine imagines
respond: respond
enthusiasm: enthusiasm
patience: patience
leatherface: leatherface
terrorize: terrorize
idealistic: idealistic
carefully: carefully
shield: shielded
texa: texas
pain: pain
farmer: farmer
game: game games
strict: strict
trail: trail
ranger: rangers ranger
pair: paired pair
road: roads road
lifetime: lifetime
brigg: briggs
chan: channing
tatum: tatum
lulu: lulu
malinois: malinois
dog: dog
buckle: buckle
ford: ford
bronco: bronco
pacific: pacific
coast: coast
funeral: funeral
drive: drive
crazy: crazy
handful: handful
evade: evade
happiness: happiness
guccus: gucci
italian: italian
patrizia: patrizia
reggiani: reggiani
lady: lady
gaga: gaga
humble: humble
beginning: beginnings
gucci: gucci
unbridled: unbridled
legacy: legacy legacies
reckless: reckless
betrayal: betrayal
decadence: decadence
connection: connection connections
ghostbuster: ghostbusters
grandfather: grandfather
starve: starving
bedding: bedding
shag: shag
aramis: aramis
athos: athos
porthos: porthos
twin: twin
imprison: imprisoned
iron: iron
mask: mask
remains: remains
adaptation: adaptation
autobiography: autobiography
pianist: pianist
true: true
warsaw: warsaw
wladyslaw: wladyslaw
szpilman: szpilman
polish: polish
radio: radio
gradually: gradually
ghetto: ghetto
operation: operations operation
reinhard: reinhard
employer: employers
abject: abject
refuge: refuge
hitman: hitman
request: request
method: methods
dea: dea
beloved: beloved
golden: golden
jane: jane
austen: austen
novel: novel
rosamund: rosamund
pike: pike
elizabeth: elizabeth
keira: keira
knightley: knightley
mary: mary
talulah: talulah
riley: riley
kitty: kitty
carey: carey
mulligan: mulligan
lydia: lydia
bennet: bennet
jena: jena
malone: malone
georgian: georgian
bingley: bingley
simon: simon
darcy: darcy
matthew: matthew
macfadyen: macfadyen
neighborhood: neighborhood
gomez: gomez
by: by
daylight: daylight
marinette: marinette
adrien: adrien
agreste: agreste
unbeknownst: unbeknownst
huge: huge
kwamus: kwami
superhero: superhero superheroes
ladybug: ladybug
cat: cat
noir: noir
hawk: hawk
moth: moth
cope: cope
responsibility: responsibilities
most: most
romantic: romantic
aside: aside
duty: duty
unaware: unaware
moon: moon
jay: jay
bartender: bartender
interest: interest
now: now
decrepit: decrepit
casual: casual
weekly: weekly
anonymous: anonymous
at: at
purely: purely
street: street streets
grey: grey
suburb: suburbs
pub: pub
theatre: theatre
evening: evenings
claire: claire
andy: andy
clear: clear
intimacy: intimacy
illicit: illicit
session: sessions
previous: previous
tragedy: tragedy
eternal: eternals
alien: alien aliens
shadow: shadows
reunite: reunite
deviant: deviants
roy: roy
biggest: biggest
company: company
peacock: peacock
sitcom: sitcom
dramatic: dramatic
complicate: complicated
philadelphia: philadelphia
gate: gated
collide: collide
reckon: reckons
bias: biases
tumbbad: tumbbad
generation: generation generations
temple: temple
goddess: goddess goddesses
hastar: hastar
worship: worshiped
entity: entity
curse: curse
emphasis: emphasis
nature: nature
prosperity: prosperity
god: gods god
favorite: favorite
ownership: ownership
overpower: overpowered
intervene: intervened
beg: begged
condition: condition
mention: mentioned
purana: puranas
grapple: grapple
issue: issues
focus: focuses
rue: rue
jules: jules
extremely: extremely
popular: popular
npc: npc
existence: existence
player: player players
interaction: interactions
massive: massive
affect: affects
plain: plains
toward: toward
bastion: bastion
uncolonised: uncolonised
akhandanand: akhandanand
tripathi: tripathi
carpet: carpet
exporter: exporter
mirzapur: mirzapur
munna: munna
unworthy: unworthy
inherit: inherited inherit
procession: procession
ramakant: ramakant
pandit: pandit
upstand: upstanding
guddu: guddu
bablu: bablu
snowball: snowballs
lawless: lawless
rebecca: rebecca
pearson: pearson
triplet: triplets
occur: occurred
birthday: birthday
offspring: offspring
kevin: kevin
generally: generally
upbringing: upbringing
smooth: smooth
sailing: sailing
baggage: baggage
outward: outward
weight: weight
visible: visible
may: may
demonstrate: demonstrate
tie: ties
conception: conception
medical: medical
meredith: meredith
aspire: aspiring
surgeon: surgeon surgeons
elli: ellis
throughout: throughout
seattle: seattle
grace: grace
hospital: hospitals hospital
storm: storm
pummeling: pummeling
meyer: meyer
lande: landes
castaing: castaing
tap: tapped
investigation: investigations investigation
shake: shook shaken
failure: failure
ostracize: ostracized
artificial: artificial
everywhere: everywhere
so: so
rely: relies
wicked: wicked
quiet: quiet
residential: residential
domestic: domestic
hostage: hostage
intrusive: intrusive
neighbour: neighbour
enterprising: enterprising
hysterical: hysterical
outside: outside
yonyx: yonyx
elsewhere: elsewhere
jealous: jealous
bewilder: bewildered
indoor: indoor
maybe: maybe
los: los
angeles: angeles
nowadays: nowadays
comedian: comedian
fierce: fierce
humor: humor
ann: ann
internationally: internationally
renowned: renowned
singer: singer
spotlight: spotlight
glamorous: glamorous
annette: annette
distribution: distribution
hindi: hindi
literature: literature
darjeel: darjeeling
juhi: juhi
adhikary: adhikary
rhea: rhea
rajguru: rajguru
plagiarism: plagiarism
plead: pleads
crosshair: crosshairs
adverse: adverse
psychological: psychological
combat: combat
shocking: shocking
revelation: revelation
amidst: amidst
complicated: complicated
juhus: juhi
adhikari: adhikari
plausible: plausible
mukherjee: mukherjee
vicky: vicky
rai: rai
cunning: cunning
owner: owner
chhattisgarh: chhattisgarh
jagannath: jagannath
arrange: arranged
celebrate: celebrate
acquittal: acquittal
shelter: shelter
radar: radar
dcp: dcp
sudha: sudha
bhardwaj: bhardwaj
suraj: suraj
yadav: yadav
bureau: bureau
unintended: unintended
halt: halt
foul: foul
version: versions version
weave: weave
richa: richa
chadda: chadda
pratik: pratik
gandhi: gandhi
cbi: cbi
reference: reference
nomi: nomi
las: las
vegas: vegas
unspoken: unspoken
tough: tough
streetwise: streetwise
veneer: veneer
infallible: infallible
vega: vegas
cautious: cautious
willing: willing
goodness: goodness
combination: combination
cheetah: cheetah
joint: joint
abrams: abrams
costumer: costumer
topless: topless
production: production
stardust: stardust
headliner: headliner
cristal: cristal
connor: connors
nomus: nomi
zack: zack
through: through
jame: james
smith: smith
whatever: whatever
odd: odd
largely: largely
natural: natural
albeit: albeit
surface: surface
bad: bad
especially: especially
alexia: alexia
skull: skull
injury: injury
titanium: titanium
plate: plate
fit: fit fitted
embrace: embraces
passionately: passionately
car: car cars
vincent: vincent
tortured: tortured
preserve: preserve
inject: injecting
steroid: steroids
liesenborg: liesenborgs
underwater: underwater
finding: findings
serious: serious
interior: interior
bottom: bottom
awaken: awakens
haunt: haunts
berman: berman
brain: brain
athlete: athletes athlete
basket: basket
detention: detention
chemistry: chemistry
walter: walter
white: white
diagnose: diagnosed
cancer: cancer
cerebral: cerebral
palsy: palsy
determined: determined
walt: walt
remarkably: remarkably
proficient: proficient
manufacture: manufacturing
methamphetamine: methamphetamine
fatal: fatal
diagnosis: diagnosis
hard: hard
morality: morality
trade: trade
jackenyon: jackenyon
jayakrishnan: jayakrishnan
estate: estate
varki: varki
railway: railway
project: project
shark: shark
xavier: xavier
ashraf: ashraf
hajji: hajji
price: price
dire: dire
reacher: reacher
conspiracy: conspiracy
dirty: dirty
scheme: scheming
wit: wits
margrave: margrave
georgium: georgia
bounty: bounty
boba: boba
fett: fett
underworld: underworld
galaxy: galaxy
fennec: fennec
shand: shand
sand: sands
tatooine: tatooine
stake: stake
formerly: formerly
deceased: deceased
jabba: jabba
hutt: hutt
fly: flies fly
nedumaaran: nedumaaran
rajangam: rajangam
maara: maara
common: common
capital: capital
intensive: intensive
sheer: sheer
suicide: suicide
squad: squad
peacemaker: peacemaker
bloodsport: bloodsport
epic: epic
tolkien: tolkien
hobbit: hobbit
ring: rings ring
forge: forged
glory: glory
finest: finest
thread: threads
flow: flowed
pen: pen
darkness: darkness
ensemble: ensemble
familiar: familiar
darkest: darkest
misty: misty
majestic: majestic
lindon: lindon
númenor: númenor
furthest: furthest
carve: carve
en: en
route: route
visit: visit
grave: grave
apparently: apparently
ritualistically: ritualistically
desecrate: desecrated
slaughterhouse: slaughterhouse
drop: drop
sinister: sinister
eat: eat
delicious: delicious
roadside: roadside
gas: gas
nightmare: nightmare
cannibal: cannibals
tool: tools
lack: lack
brooke: brooke
tuscany: tuscany
italy: italy
plague: plague
loom: looms
sincerely: sincerely
novice: novice
benedetta: benedetta
carlini: carlini
theatine: theatine
convent: convent
pescia: pescia
jesus: jesus
christ: christ
eighteen: eighteen
ominous: ominous
whisper: whispers
disputable: disputable
miracle: miracles
scandalise: scandalise
cloistered: cloistered
faith: faith
await: awaits
pious: pious
shape: shape
bruise: bruised
earthly: earthly
bartolomea: bartolomea
vigilant: vigilant
cynical: cynical
abbess: abbess
felicita: felicita
fleeting: fleeting
glimpse: glimpses
forbid: forbidden
fruit: fruit
invite: invite
tentative: tentative
ungovernable: ungovernable
diabolical: diabolical
manifest: manifest
wrestle: wrestle
unscathed: unscathed
alex: alex
tunnel: tunnel
marcus: marcus
gaspar: gaspar
noé: noé
controversy: controversy
brand: brand
cult: cult
initially: initially
operate: operated
anechronological: anechronological
irreversible: irreversible
inversion: inversion
filmmaker: filmmaker
reading: reading
chronological: chronological
untarnished: untarnished
rapacious: rapacious
betty: betty
foot: foot
bustling: bustling
hollywood: hollywood
brim: brimming
spread: spread
wing: wings
ruth: ruth
expensive: expensive
store: store stores
setting: setting
indecipherable: indecipherable
centre: centre
elaborate: elaborate
labyrinth: labyrinth
fade: faded
unrequited: unrequited
keyhole: keyhole
cube: cube
adam: adam
cryptic: cryptic
brunette: brunette
devilishly: devilishly
seductive: seductive
rita: rita
opaque: opaque
demand: demands
serpentine: serpentine
mulholland: mulholland
georgia: georgia
nolan: nolan
firefighter: firefighter firefighters
arsonist: arsonist
broadway: broadway
shawn: shawn
retirement: retirement
mayor: mayor
disguise: disguises
joe: joe
heartbroken: heartbroken
bell: bell
sit: sits
wine: wine
stare: staring
window: window
handsome: handsome
neighbor: neighbor
that: that
gruesome: gruesome
or: or
mediocre: mediocre
paper: paper
scranton: scranton
pa: pa
manager: manager
mockumentary: mockumentary
everyday: everyday
quite: quite
humorous: humorous
thrive: thriving
worker: workers
surgically: surgically
colleague: colleagues colleague
sanga: sanga
tribe: tribe
province: province
mahismathus: mahismathi
drown: drowning
infant: infant
background: background
shivudu: shivudu
bhallala: bhallala
deva: deva
paridhi: paridhi
honest: honest
baffle: baffled
department: department
dedicated: dedicated
shrimati: shrimati
sl: sl
loney: loney
ji: ji
shri: shri
irodov: irodov
maanniya: maanniya
hc: hc
verma: verma
factory: factory
tvf: tvf
aspirant: aspirant aspirants
gopan: gopan
piece: piece
chittur: chittur
construction: construction
evict: evicted
spaceship: spaceship
fighter: fighter
jet: jets
crash: crash
populate: populated
intend: intend
outskirts: outskirts
coastal: coastal
barent: barents
whale: whales
sometimes: sometimes
bay: bay
kolya: kolya
aleksey: aleksey
serebryakov: serebryakov
lilya: lilya
lyadova: lyadova
romka: romka
haunted: haunted
roman: roman
madyanov: madyanov
repair: repair
shop: shop
to: to
vdovichenkov: vdovichenkov
authoritative: authoritative
attorney: attorney
collect: collect
dirt: dirt
january: january
union: union
icy: icy
ural: ural
nine: nine
ski: ski
trek: trek
though: though
hiker: hikers
destination: destination
investigator: investigators
puzzle: puzzled
tent: tent
stiff: stiff
underwear: underwear
partially: partially
mangled: mangled
whom: whom
why: why
kgb: kgb
inquiry: inquiry
strictly: strictly
confidential: confidential
troubled: troubled
veteran: veteran
katya: katya
examiner: examiner
reason: reason
deepest: deepest
borehole: borehole
organization: organization
patriot: patriot
republic: republics
psychologist: psychologist
evaluate: evaluate
edgy: edgy
cell: cell
nation: nation
terrorist: terrorists
secretive: secretive
low: low
jaison: jaison
tovino: tovino
thoma: thomas
tailor: tailor
kurukkanmoola: kurukkanmoola
obtain: obtains
superpower: superpowers
enhance: enhanced
speed: speed
agility: agility
reflex: reflexes
bolt: bolt
lightning: lightning
minnal: minnal
antagonist: antagonist
selvan: selvan
guru: guru
somasundaram: somasundaram
vellidi: vellidi
venkitus: venkiti
pranav: pranav
theme: theme
reincarnation: reincarnation
kolkata: kolkata
hyderabad: hyderabad
entrepreneur: entrepreneurs
pitch: pitch
panel: panel
investor: investors
persuade: persuade
invest: invest
biopic: biopic
mahavir: mahavir
phogat: phogat
wrestling: wrestling
babita: babita
kumari: kumari
geeta: geeta
wrestler: wrestler
commonwealth: commonwealth
medal: medal
kg: kg
silver: silver
genghi: genghis
khan: khan
temüjin: temüjin
börte: börte
starvation: starvation
humiliation: humiliations
overcome: overcomes
hardship: hardships
wonderland: wonderland
river: rivers
canal: canals
bustle: bustle
skater: skaters
market: markets market
matvey: matvey
delivery: delivery
bakery: bakery
poor: poor
lamplighter: lamplighter
skate: skates
unjustly: unjustly
pickpocket: pickpockets
alisa: alisa
science: science
julia: julia
comic: comic
artist: artist
flu: flu
petrov: petrov
igor: igor
drift: drifting
scam: scams scam
harshad: harshad
mehta: mehta
meteoric: meteoric
flamboyant: flamboyant
bull: bull
stock: stock
feisty: feisty
journalist: journalist
sucheta: sucheta
dalal: dalal
sartaj: sartaj
blow: blow
amid: amid
standard: standards
enforcement: enforcement
perceive: perceives
theory: theories
abhilash: abhilash
shwetketu: shwetketu
sk: sk
guri: guri
upsc: upsc
cse: cse
rajinder: rajinder
nagar: nagar
talk: talks
importantly: importantly
besides: besides
atwal: atwals atwal
heinous: heinous
length: lengths
remove: remove
pawn: pawns
pharmaceutical: pharmaceutical
wrap: wraps
galactic: galactic
climate: climate
tropical: tropical
ice: iced
tower: towers
stadium: stadium
intergalactic: intergalactic
cosmoball: cosmoball
competition: competitions
combine: combines
sport: sport
gladiator: gladiator
contest: contest
ability: ability abilities
adore: adores
destine: destined
mus: mus
grom: grom
penetrative: penetrative
irreconcilable: irreconcilable
attitude: attitude
stripe: stripes
dramatically: dramatically
appearance: appearance
sick: sick
lawlessness: lawlessness
treatment: treatment
punishment: punishment
status: status
agitate: agitated
powerless: powerless
difficulty: difficulties
outcome: outcome
colossal: colossal
talented: talented
sens: senses
currently: currently
spotty: spotty
chaotic: chaotic
unstable: unstable
collection: collection
recollection: recollections
glacier: glaciers
physics: physics
exact: exact
regulation: regulations
exit: exit
acquaint: acquainted
midst: midst
miroslava: miroslava
castle: castle
mira: mira
groom: groom
cage: cage
arman: arman
loving: loving
scary: scary
akhmadulla: akhmadulla
novocherkassk: novocherkassk
ussr: ussr
lyudmila: lyudmila
communist: communist
stalin: stalin
ideology: ideology
certain: certain
detest: detests
sentiment: sentiment
strike: strike strikes
electromotive: electromotive
laborer: laborers
piquet: piquet
gun: gunned
bloodbath: bloodbath
square: square
disappear: disappears disappeared
gape: gaping
rift: rift
worldview: worldview
blockade: blockade
abigail: abigail
epidemic: epidemic
disease: disease
abby: abby
historical: historical
rearguard: rearguard
july: july
vicinity: vicinity
fort: fort
vishalgad: vishalgad
kolhapur: kolhapur
maharashtra: maharashtra
maratha: maratha
baji: baji
prabhu: prabhu
deshpande: deshpande
siddi: siddi
masud: masud
adilshah: adilshah
sultanate: sultanate
pavan: pavan
khind: khind
kulkarnus: kulkarni
foreign: foreign
tourist: tourist
harry: harried
kasturus: kasturi
replacement: replacement
angad: angad
skeleton: skeletons
bloodthirsty: bloodthirsty
killing: killing
underbelly: underbelly
testing: testing
manu: manu
bodybuilder: bodybuilder
chandigarh: chandigarh
maanvi: maanvi
zumba: zumba
turmoil: turmoil
virus: virus
electricity: electricity
value: value
fuel: fuel
sergei: sergei
autistic: autistic
spite: spite
rush: rushes
hate: hates
isolated: isolated
desert: deserted
outbreak: outbreak
tv: tv
bestsell: bestselling
vongozero: vongozero
write: written
yana: yana
vagner: vagner
translate: translated
eleven: eleven
maryana: maryana
spivak: spivak
principle: principle
loveless: loveless
andrei: andrei
zvyagintsev: zvyagintsev
jury: jury
oppressive: oppressive
galina: galina
brutal: brutal
pasha: pasha
boundless: boundless
adjust: adjusting
sullen: sullen
manners: manners
total: total
lust: lusts
kolka: kolka
impairment: impairments
taste: taste
pinocchio: pinocchio
genius: genius
creator: creator
jepetto: jepetto
horse: horse
tibalt: tibalt
circus: circus
hustler: hustler
modjafocco: modjafocco
selling: selling
fox: fox
spectator: spectators
robbery: robberies
bella: bella
lucilda: lucilda
lena: lena
patient: patients
thank: thank
safely: safely
actor: actor
theater: theater
interfere: interfere
notice: notice
behavior: behavior
read: reads
text: text
message: messages
passion: passion
integral: integral
double: double
stalingrad: stalingrad
award: awards
reward: reward
how: how
defeated: defeated
tilkin: tilkin
meteorite: meteorites
atomic: atomic
sever: severed
who: who
aggressively: aggressively
pursued: pursued
drastic: drastic
measure: measures
reclaim: reclaim
